[005][005][005][005][005][005][005][005][005][005][005][005][005][005][005][005]
[005][011][011][011][011][011][011][011][011][011][011][011][011][011][008][005]
[005][011][011][011][011][000][001][001][001][002][011][011][011][011][011][005]
[005][001][001][001][001][005][005][005][005][005][001][002][011][011][011][005]
[005][009][009][009][009][009][009][009][005][005][005][006][011][011][011][005]
[005][011][011][011][011][011][011][011][008][005][005][005][001][011][011][005]
[005][011][011][011][011][011][011][011][011][008][009][010][011][011][011][005]
[005][011][011][011][011][011][011][011][011][011][011][011][011][011][011][005]
[005][011][011][011][011][011][011][011][011][011][011][011][011][000][005][005]
[005][011][011][001][003][003][003][001][002][011][011][011][000][010][011][005]
[005][001][011][005][005][005][005][005][008][002][011][000][010][011][011][005]
[005][011][011][011][011][011][011][011][011][008][001][010][011][011][011][005]
[005][011][001][001][001][001][011][011][011][011][011][011][011][011][011][005]
[005][011][011][011][011][011][011][011][011][011][011][011][011][011][011][005]
[005][002][011][000][015][015][002][011][011][011][011][011][011][011][011][005]
[005][005][005][005][005][005][005][005][005][005][005][005][005][005][005][005]
